145111111111111
300000000100001
201010100100001
100000000100001
155000055100001
200000000100001
200000000100001
200010000100001
200044000100001
133331333100001
111111111100001
111111111100001
111111111111111
