111111111111111
100000000100001
101010100100001
100000000100001
111000011100001
100000000100001
100000000100001
100010000100001
100011000100001
111111111100001
111111111100001
111111111100001
111111111111111
