1111111111111111
1145111111111111
1300000000100001
1201010100100001
1100x00000100001
1155000055100001
1200000000100001
1200000000100001
1200010000100001
1200044000100001
1133331333100001
1111111111100001
1111111111100001
1111111111111111
