11111111111
1000000001
x10101001
1000000001
1110000111
1000000001
1000000001
1000100001
1000110001
1111111111
1111111111
1111111111
1111111111
