1111115555555555222222222222222
3333350000000005200000000000222
30x0315555555505200000000000222
3000311111111101200000000000002
3000310000000001222222222222202
1404441000000001111111111111101
1400000000000001000000000000001
1444441100000001000000000000111
1111111100000000000000000000111
1111111111111111011111111111111
1000001001000000000000001000001
1000001000000000000010000000001
1010000000001000000000010010001
1001000010000000010000000000001
1000100000000000000000001001001
1001000000100000010000000000001
1000000000111111100000100001001
1111111111111111111111111111111
