111111111111111111111111111111111
111111155555555552222222222222221
133333500000000052000000000002221
130x03155555555052000000000002221
130003111111111012000000000000021
130003100000000012222222222222021
114044410000000011111111111111011
114000000000000010000000000000011
114444411000000010000000000001111
111111111000000000000000000001111
111111111111111110111111111111111
110000010010000000000000010000011
110000010000000000000100000000011
110100000000010000000000100100011
110010000100000000100000000000011
110001000000000000000000010010011
110010000001000000100000000000011
110000000001111111000001000010011
111111111111111111111111111111111
111111111111111111111111111111111
