11111111111111111111111111111111111111
10000000000000000000000000000000000001
10000000000000000000000000000000000001
10000000000000000000000000000000000001
10000000000000000000000000000000000001
10000001000000000000000000000000000001
10000001000000000000000000000000000001
10000011000000000000000000000000000001
10001010000000000000000000000000000001
10000010000000000000000000000000000001
10100010000000000000000000000000000001
10000110000000000000000000000000000001
11000010000000000000000000000000000001
10000010000000000000000000000000000001
10010100000000000000000000000000000001
10000010000000000000000000000000000001
10000100000000000000000000000000000001
10000100000000000000000000000000000001
10001000000000000000000000000000000001
10011000000000000000000000000000000001
10000100000000000000000000000000000001
10000010000000000000000000000000000001
10000010000000000000000000000000000001
10000001000000000000000000000000000001
10000000111100000000000000000000000001
10000000000000000000000000000000000001
10000000000000000000000000000000000001
10000000000000000000000000000000000001
10000000000000000000000000000000000001
10000000000000000000000000000000000001
10000000000000000000000000000000000001
11111111111111111111111111111111111111
